    Z          W
   GGG      Z  W
           GGG W
       B       W
               W
GGGGGGGGGGGG   W

R             F
GGSSSGGGGSSGGGGG